0 0 1 1 1 1 1 1 0 0
0 1 0 0 3 0 0 1 1 0
1 0 0 7 3 7 0 0 1 1
1 0 4 1 3 1 4 0 0 1
1 0 4 0 0 0 4 0 0 1
1 1 1 1 1 1 1 0 0 1
1 0 0 0 1 1 1 0 0 1
1 0 4 3 4 3 4 0 0 1
1 1 0 5 0 3 0 0 1 0
0 1 1 1 1 1 1 1 0 0