0 0 1 1 1 1 0 0 0 0
0 0 1 1 1 1 1 0 0 0
0 0 1 0 0 0 1 0 0 0
0 0 1 3 7 3 1 1 1 0
0 0 1 0 0 7 0 0 1 1
0 0 1 0 4 3 7 7 1 1
0 0 1 0 0 4 0 1 1 0
0 0 1 0 4 0 1 1 0 0
0 0 1 5 0 1 1 0 0 0
0 0 1 1 1 1 0 0 0 0