1 1 1 0 0 0 0 0 0 0
1 1 1 1 0 0 0 0 0 0
1 0 0 1 1 1 1 1 0 0
1 0 0 0 0 5 0 1 1 0
1 0 3 7 3 4 7 0 1 1
1 1 0 0 1 4 0 0 1 1
0 1 1 0 0 0 1 1 1 0
0 0 1 1 1 1 1 0 0 0
0 0 0 1 1 1 0 0 0 0
0 0 0 0 0 0 0 0 0 0