0 0 0 0 0 0 1 1 0 0
0 0 0 0 0 1 1 1 1 0
0 1 1 1 1 1 0 0 1 0
1 1 0 0 0 3 3 4 1 1
1 1 0 4 5 1 0 4 0 1
1 1 1 4 3 3 0 0 0 1
0 0 1 0 0 1 1 0 0 1
0 0 1 1 1 1 1 1 1 1
0 0 0 1 1 1 1 1 1 1
0 0 0 0 0 0 0 0 0 0