0 0 0 0 1 1 1 1 0 0
0 0 0 1 1 0 0 1 0 0
0 0 1 0 0 0 0 1 0 0
0 0 1 0 0 0 0 1 0 0
0 0 1 1 1 4 4 1 0 0
0 0 0 0 1 3 3 1 0 0
0 0 0 0 1 3 3 1 0 0
0 0 0 1 5 4 4 0 1 0
0 0 0 1 0 0 0 0 1 0
0 0 0 1 1 1 1 1 1 0