0 0 0 0 0 1 1 1 0 0
0 0 0 0 1 0 0 1 0 0
0 0 0 1 0 0 0 1 0 0
0 0 1 0 1 3 4 1 1 0
0 1 0 0 3 3 5 0 1 0
1 1 0 0 4 4 7 0 1 0
1 1 1 1 1 0 0 0 1 0
0 0 0 0 1 0 0 1 0 0
0 0 0 0 1 1 1 1 0 0
0 0 0 0 0 1 1 1 0 0