0 0 0 0 0 0 0 0 0 0
0 0 0 1 1 1 1 0 0 0
0 0 0 1 0 0 1 1 1 0
0 1 1 1 0 3 0 0 1 0
0 1 5 4 4 4 0 0 1 0
0 1 0 0 0 1 3 0 1 0
0 1 1 1 3 0 0 1 1 0
0 0 0 1 1 1 1 1 0 0
0 0 0 0 1 1 1 0 0 0
0 0 0 0 0 0 0 0 0 0