0 0 1 1 1 1 0 0
0 1 1 0 0 1 0 0
0 1 5 4 0 1 0 0
0 1 1 4 0 1 1 0
0 1 1 0 4 0 1 0
0 1 3 4 0 0 1 0
0 1 3 3 7 3 1 0
0 1 1 1 1 1 1 0