0 0 0 0 0 0 0 0 0 0
0 0 1 1 1 1 0 0 0 0
0 0 1 0 0 1 0 0 0 0
0 0 1 0 0 1 1 1 1 0
0 0 1 0 3 3 7 0 1 0
0 1 1 0 4 4 5 0 1 0
0 1 0 0 0 1 1 1 1 0
0 1 0 0 0 1 0 0 0 0
0 1 1 1 1 1 0 0 0 0
0 0 0 0 0 0 0 0 0 0