1 1 1 0 0 0 0 0
0 0 1 1 1 1 0 0
0 0 1 0 0 1 1 0
0 0 1 5 3 0 1 0
0 0 1 3 3 4 1 1
0 0 1 0 4 4 0 1
0 0 1 0 0 0 0 1
0 0 1 1 1 1 1 1