0 0 0 0 0 0 0 0 0 0
0 0 0 0 1 1 1 1 1 0
0 0 0 1 1 1 1 1 1 0
0 0 1 1 0 0 0 5 1 0
0 1 1 3 4 4 4 0 1 0
0 1 1 3 3 4 0 1 1 0
0 1 1 0 3 0 0 1 0 0
0 1 1 1 1 1 1 1 0 0
0 1 1 1 1 1 1 0 0 0
0 0 0 0 0 0 0 0 0 0