0 0 0 0 0 0 0 0 0 0
0 1 1 1 1 0 0 0 0 0
0 1 1 1 1 1 1 1 1 0
0 1 1 0 0 0 0 0 1 0
0 1 1 0 4 8 4 0 1 0
0 0 1 3 7 1 7 3 1 0
0 0 1 0 4 3 4 0 1 0
0 0 1 0 0 0 0 0 1 0
0 0 1 1 1 1 1 1 1 0
0 0 0 0 0 0 0 0 0 0