0 0 0 0 0 0 0 0 0 0
0 1 1 1 1 1 0 0 0 0
0 1 1 1 1 1 1 0 0 0
0 1 5 0 1 7 1 1 0 0
0 1 0 4 4 0 3 1 1 0
0 1 0 0 0 0 0 1 1 0
0 1 0 0 1 3 7 1 1 0
0 1 1 1 1 1 1 1 1 0
0 1 1 1 1 1 1 1 1 0
0 0 0 0 0 0 0 0 0 0