0 0 0 0 0 0 0 0 0 0
0 1 1 1 0 0 0 0 0 0
0 1 1 1 1 0 0 0 0 0
0 1 0 0 1 1 1 1 0 0
0 1 3 4 3 0 0 1 1 0
0 1 0 7 4 4 0 0 1 0
0 1 0 0 8 4 0 0 1 0
0 1 0 0 1 3 0 1 1 0
0 1 1 1 1 1 1 1 0 0
0 0 0 0 0 0 0 0 0 0