0 0 0 0 0 0 0 0 0 0
0 0 0 0 1 1 1 0 0 0
0 0 0 1 0 5 3 1 0 0
0 0 1 0 4 4 7 0 1 0
0 1 1 0 0 1 3 0 1 0
0 1 1 0 0 0 0 0 1 0
0 0 1 0 4 1 0 0 1 0
0 0 0 1 0 0 3 1 0 0
0 0 0 0 1 1 1 0 0 0
0 0 0 0 0 0 0 0 0 0