0 1 1 1 1 1 0 0
0 1 0 5 1 1 1 0
0 1 0 4 0 0 1 0
1 1 1 0 1 0 1 1
1 3 1 0 1 0 0 1
1 3 4 0 0 1 0 1
1 3 0 0 0 4 0 1
1 1 1 1 1 1 1 1